20 20
200 100
13 13 13 13 13 13 13 13 13 13 13 13 13 13 13 13 13 13 13 13
13 13 13 13 13 13 13 13 13 13 13 13 13 13 13 13 13 13 13 13
13 13 13 13 13 13 13 13 13 13 13 13 13 13 13 13 13 13 13 13
13 13 13 13 13 13 13 13 13 13 13 13 13 13 13 13 13 13 13 13
7 7 7 7 7 7 7 7 7 7 7 7 7 7 7 7 7 7 7 7
7 7 7 7 7 7 7 7 7 7 7 7 7 7 7 7 7 7 7 7
10 10 10 10 8 7 7 7 7 7 10 10 10 8 7 7 7 7 7 7
11 11 11 11 9 6 6 6 6 6 11 11 11 9 6 6 6 6 6 6
12 12 12 12 12 12 12 12 12 12 12 12 12 12 12 12 12 12 12 12
0 0 0 0 0 0 0 12 12 0 0 0 0 0 0 0 0 0 0 0
0 0 0 0 0 0 0 12 12 0 0 0 0 0 0 0 0 0 0 0
0 0 0 0 0 0 0 12 12 0 0 0 0 0 0 0 0 0 0 0
0 0 0 0 0 0 0 12 12 0 0 0 0 0 0 0 0 0 0 0
0 0 0 0 0 0 0 12 12 0 0 0 0 0 0 0 0 0 0 0
0 0 0 0 0 0 0 12 12 0 0 0 0 0 0 0 0 0 0 0
0 0 0 0 0 0 0 12 12 0 0 0 0 0 0 0 0 0 0 0
14 14 14 14 14 14 14 14 14 14 14 14 14 14 14 14 14 14 14 14
13 13 13 13 13 13 13 13 13 13 13 13 13 13 13 13 13 13 13 13
0 0 0 0 0 0 0 0 0 0 0 0 0 0 0 0 0 0 0 0
0 0 0 0 0 0 0 0 0 0 0 0 0 0 0 0 0 0 0 0