20 20
200 100
4 4 4 4 4 4 4 4 4 4 4 4 4 4 4 4 4 4 4 4
4 4 4 4 4 4 4 4 4 4 4 4 4 4 4 4 4 4 4 4
4 4 4 4 4 4 5 5 5 5 5 5 5 4 4 4 4 4 4 4
4 4 4 4 4 4 5 5 5 5 5 5 5 5 4 4 4 4 4 4
4 4 4 4 4 4 5 5 5 5 5 5 5 4 4 4 4 4 4 4
4 4 4 4 4 4 5 5 5 5 5 5 5 4 4 4 4 4 4 4
4 4 4 4 4 4 5 5 5 5 5 5 5 4 4 4 4 4 4 4
4 4 4 4 4 4 5 5 5 5 5 5 5 4 4 4 4 4 4 4
4 4 4 4 4 4 5 5 5 5 5 5 5 4 4 4 4 4 4 4
4 4 4 4 4 4 5 5 5 5 5 5 5 4 4 4 4 4 4 4
4 4 4 4 4 4 5 5 5 5 5 5 5 4 4 4 4 4 4 4
4 4 4 4 4 4 5 5 5 5 5 5 5 4 4 4 4 4 4 4
4 4 4 4 4 4 5 5 5 5 5 5 5 4 4 4 4 4 4 4
4 4 4 4 4 4 5 5 5 5 5 5 5 4 4 4 4 4 4 4
4 4 4 4 4 4 5 5 5 5 5 5 5 4 4 4 4 4 4 4
4 4 4 4 4 5 5 5 5 5 5 5 5 4 4 4 4 4 4 4
4 4 4 4 4 5 5 5 5 5 5 5 5 5 4 4 4 4 4 4
4 4 4 4 4 5 5 5 5 5 5 5 5 4 4 4 4 4 4 4
4 4 4 4 4 4 4 4 4 4 4 4 4 4 4 4 4 4 4 4
4 4 4 4 4 4 4 4 4 4 4 4 4 4 4 4 4 4 4 4